#######
#.....#
#####.#
#####.#
#####.#
#####X#
####### 